NO ./img/wall1.xpm
SO ./img/wall2.xpm
WE ./img/wall3.xpm
EA ./img/wall4.xpm

F 24,180,75
C 20,220,70

        1111111111111111111111111111111111111111111111111111111111111111111111111111111111111111111
        1000000000110000000000000000000000000000000000000000000000000000000000000000000000000000001
        1011000001110000000000000000000000000000000000000000000000000000000000000000000000000000001
        1001000000000000000000000000000001000000000000000000000000000000000000000000000000000111111
1111111110110000011100000000000000000000110000000000000000000000000000000000000000000000000001
1000000000110000011101111111111111101111111111111111110111111111111111101111111111111111111111
1111011111111101110000001000100000000000110000000000000000000000000000000000000000000000000001
1111011111111101110101001000100000000000100000000000000000000000000000000000000000000000000001
1100000011010101110000001000000000000000000000000000000000000000000000000000000000000000000001
1000000000000000000000000000000000000000000000000000000000000000000000000000000000000000000001
100000000000S000000000000000000000000000000000000000000000000000000000000000000000000000000001
1100000111010101111101111000111100001100000000000000000000000000000000000000000000000000000001
1111011111110101101001001000101111100011000000000000000000000000000000000000000000000000000001
1111111111111111111111111111111111111111111111111111111111111111111111111111111111111111111111
