NO ./img/one64.xpm
SO ./img/one64.xpm
WE ./img/coin64.xpm
EA ./img/coin64.xpm

F 220,100,0
C 225,30,0

11111
10001
10001
101S1
11111
