NO ./img/one64.xpm
SO ./img/p64.xpm
WE ./img/coin64.xpm
EA ./img/zero64.xpm

F 220,100,0
C 225,30,0

1111111111111111111111111111111
1000000000S0000110000000000001
100000000000001110000000000001
1000000001000000000000000000001
10000000011000001110000000000011
100000000011000001110111111111111
11110111111111011100000010001
11110111111111011101010010001
11000000110101011100000010001
10000000000000001100000010001
10000000000000001101010010001
1100000111010101111101111000111
11110111 1110101 101111010001
11111111 1111111 111111111111
