NO ./img/one64.xpm
SO ./img/one64.xpm
WE ./img/coin64.xpm
EA ./img/coin64.xpm

F 220,100,0
C 285,30,0

11111
10001
10N01
10001
11111
